###########
#         #
#         #
#         #
#         #
#         #
#         #
#         #
#         P
#         #
#         #
#         #
#         #
#         #
#         #
#         #
#         #
####P######

###########
#         #
#         #
#         #
#         #
#         #
#         #
#         #
P         P
#         #
#         #
#         #
#         #
#         #
#         #
#         #
#         #
####P######

###########
#         #
#         #
#         #
#         #
#         #
#         #
#         #
P         #
#         #
#         #
#         #
#         #
#         #
#         #
#         #
#         #
####P######

####P######
#         #
#         #
#         #
#         #
#         #
#         #
#         #
#         P
#         #
#         #
#         #
#         #
#         #
#         #
#         #
#         #
####P######

####P######
#         #
#         #
#    E    #
#         #
#         #
#         #
#         #
P         P
#         #
#         #
#         #
#         #
#         #
#         #
#         #
#         #
####P######

####P######
#      E  #
#      E  #
#         #
#         #
#         #
#         #
#         #
P    E    #
#         #
#         #
#         #
#         #
#         #
#         #
#         #
#         #
####P######

####P######
#         #
#         #
#         #
#         #
#         #
#         #
#         #
#         P
#         #
#         #
#         #
#         #
#         #
#         #
#         #
#         #
###########

####P######
#         #
#         #
#         #
#         #
#         #
#         #
#         #
P         P
#         #
#         #
#         #
#         #
#         #
#         #
#         #
#         #
###########

####P######
#E        #
#         #
#  E    E #
#         #
#         #
#         #
#       C #
P         #
#         #
# E   J  E#
#         #
#   EC E  #
#         #
#         #
#         #
#         #
###########

