###########
#         #
#         #
#         #
#         #
#         #
#         #
#         #
#         P
#         #
#         #
#         #
#         #
#         #
#         #
#         #
#         #
####P######

###########
#         #
#         #
#         #
#         #
#         #
#         #
#         #
P         P
#         #
#         #
#         #
#         #
#         #
#         #
#         #
#         #
####P######

###########
#         #
#         #
#         #
#         #
#         #
#         #
#         #
P         #
#         #
#         #
#         #
#         #
#         #
#         #
#         #
#         #
####P######

####P######
#         #
#         #
#         #
#         #
#         #
#         #
#         #
#      J  P
#         #
#         #
#         #
#         #
#         #
#         #
#         #
#         #
####P######

####P######
#         #
#         #
#         #
#         #
#    E    #
#         #
#         #
P         P
#         #
#       J #
#         #
#   E     #
#         #
#         #
#         #
#         #
####P######

####P######
#         #
#         #
#         #
#         #
#         #
#         #
#         #
P         #
#         #
#         #
#         #
#         #
#         #
#         #
#         #
#         #
####P######

####P######
#         #
#         #
#         #
#         #
#         #
#         #
#         #
#         P
#         #
#         #
#         #
#         #
#         #
#         #
#         #
#         #
###########

####P######
#         #
#         #
#         #
#         #
#         #
#         #
#         #
P         P
#         #
#         #
#         #
#         #
#         #
#         #
#         #
#         #
###########

####P######
#  EE     #
#  E   E  #
#  E      #
#  EE  E  #
#   EEE  E#
#         #
#        E#
P     E   #
#  E      #
#         #
#  E    E #
#  E  E   #
#     EE  #
#         #
#   J     #
#         #
###########

