###########
#         #
#         #
#         #
#         #
#         #
#         #
#         #
#         P
#         #
#         #
#         #
#         #
#         #
#         #
#         #
#         #
####P######

###########
#OO       #
# J       #
#   E     #
#         #
#         #
#         #
#         #
P         P
#         #
#         #
#         #
#    E    #
#         #
#         #
#         #
#         #
####P######

###########
#         #
#         #
#         #
#         #
#         #
#         #
#         #
P         #
#         #
#         #
#         #
#         #
#         #
#         #
#         #
#         #
####P######

####P######
#         #
#         #
#         #
#         #
#         #
#         #
#         #
#     O   P
#         #
#         #
#         #
#         #
#         #
#         #
#         #
#         #
####P######

####P######
#         #
#         #
#         #
#E        #
#         #
#         #
#         #
P         P
#         #
#         #
#         #
#         #
#         #
#  E      #
#         #
#         #
####P######

####P######
#         #
#         #
#         #
#         #
#         #
#         #
#         #
P  O      #
#         #
#         #
#         #
#         #
#         #
#         #
#         #
#         #
####P######

####P######
#         #
#         #
#         #
#         #
#         #
#         #
#         #
#         P
#         #
#         #
#         #
#         #
#         #
#         #
#         #
#         #
###########

####P######
#         #
#         #
#         #
#         #
#         #
#         #
#         #
P         P
#         #
#         #
#         #
#         #
#         #
#         #
# O       #
#O        #
###########

####P######
#         #
#         #
#         #
#         #
#         #
#         #
#         #
P         #
#         #
#         #
#         #
#         #
#         #
#         #
#         #
#         #
###########

