###########
#   C E   #
#         #
#     E   #
#         #
#         #
#         #
#         #
#         P
#         #
#         #
#         #
#         #
#         #
#         #
#         #
#         #
####P######

###########
#O        #
#EOE   E  #
#  EE  E  #
#  E      #
#         #
#         #
#         #
P         P
#         #
#         #
#         #
#         #
#         #
#         #
#         #
#         #
####P######

###########
#         #
#         #
#         #
#         #
#         #
#         #
#         #
P         #
#         #
#         #
#         #
#         #
#         #
#         #
#         #
#         #
####P######

####P######
#         #
#         #
#   J     #
#         #
#         #
#         #
#         #
#  E  O   P
# C       #
#     C   #
#         #
#   E     #
#         #
# C       #
#         #
#         #
####P######

####P######
#      E  #
#       E #
#         #
#   OO    #
#    E    #
#         #
#         #
P O       P
#OE       #
#E        #
#       E #
#   E     #
#   E     #
#         #
#         #
#         #
####P######

####P######
#         #
#         #
#  E      #
#         #
#         #
#         #
#         #
P  O      #
#         #
#         #
#         #
#         #
#         #
#         #
#         #
#         #
####P######

####P######
#         #
#         #
#         #
#         #
#         #
#         #
#         #
#         P
#         #
#         #
#         #
#         #
#         #
#         #
#         #
#         #
###########

####P######
#         #
#         #
#         #
#         #
#         #
#         #
#         #
P         P
#         #
#         #
#         #
#         #
#         #
#         #
# O       #
#O        #
###########

####P######
#         #
#         #
#         #
#         #
#         #
#         #
#         #
P         #
#         #
#         #
#         #
#         #
#         #
#         #
#         #
#         #
###########

