###########
#         #
#         #
#         #
#         #
#         #
#         #
#         #
#         P
#         #
#         #
#         #
#         #
#         #
#         #
#         #
#         #
####P######

###########
#         #
#         #
#         #
#         #
#         #
#         #
#         #
P         P
#         #
#         #
#         #
#         #
#         #
#         #
#         #
#         #
####P######

###########
#         #
#         #
#         #
#         #
#         #
#         #
#         #
P         #
#         #
#         #
#         #
#         #
#         #
#         #
#         #
#         #
####P######

####P######
#         #
#         #
#         #
#         #
#         #
#         #
#         #
#         P
#         #
#         #
#         #
#         #
#         #
#         #
#         #
#         #
####P######

####P######
#         #
#         #
#         #
#         #
#   E     #
#         #
#E        #
P   J     P
#    C    #
#         #
#         #
#         #
#         #
#         #
#     E   #
#         #
####P######

####P######
#         #
#         #
#         #
#         #
#         #
#         #
#         #
P         #
#         #
#         #
#         #
#         #
#         #
#         #
#         #
#         #
####P######

####P######
#         #
#         #
#         #
#         #
#         #
#         #
#         #
#         P
#         #
#         #
#         #
#         #
#         #
#         #
#         #
#         #
###########

####P######
#         #
#         #
#         #
#         #
#         #
#         #
#         #
P         P
#         #
#         #
#         #
#         #
#         #
#         #
#         #
#         #
###########

####P######
#         #
#         #
#         #
#         #
#         #
#         #
#         #
P         #
#         #
#         #
#         #
#         #
#         #
#         #
#         #
#         #
###########

