###########
#         #
#         #
#         #
#         #
#         #
#         #
#         #
#         P
#         #
#         #
#         #
#         #
#         #
#         #
#         #
#         #
####P######

###########
#         #
#         #
#         #
#         #
#         #
#         #
#         #
P         P
#         #
#         #
#         #
#         #
#         #
#         #
#         #
#         #
####P######

###########
# CC C  C #
#   E  E  #
#   CC EE #
#   CC    #
#J    E   #
#    EE   #
#   EC E  #
PE        #
#      E  #
#       E #
#   C   E #
#    E    #
#     C  E#
#         #
#CC       #
#         #
####P######

####P######
#         #
#         #
#         #
#         #
#         #
#         #
#         #
#         P
#         #
#         #
#         #
#         #
#         #
#         #
#         #
#         #
####P######

####P######
# E     C #
#         #
#         #
#         #
#    E    #
# C       #
#C        #
P         P
#         #
#         #
#         #
#      C  #
#         #
#         #
#         #
#         #
####P######

####P######
# C       #
#         #
#         #
#  C      #
#         #
# C       #
#         #
PE        #
#         #
#     E   #
#         #
#         #
#         #
#         #
#      C  #
#         #
####P######

####P######
#         #
#         #
#         #
#         #
#         #
#         #
#         #
#         P
#         #
#         #
#         #
#         #
#         #
#         #
#         #
#         #
###########

####P######
#         #
#         #
#         #
#         #
#         #
#         #
#         #
P         P
#         #
#         #
#         #
#         #
#         #
#         #
#         #
#         #
###########

####P######
#         #
#         #
#         #
#         #
#         #
#         #
#         #
P         #
#         #
#         #
#         #
#         #
#         #
#         #
#         #
#         #
###########

